#############
#f.........f#    ########
#...s...s...#WWWW#f....f#
#...................p...#
#...........#WWWW#......#
#...........#    #......#
#...........#    #......#
#f.........f#    #f....f#
#####..######    ###..###
    #..#           #..#
    #..#           #..#
    #..#          ##..##
  ###..####      #f....f#
  #f.@...f#      #...§..#
  #.......#      #......#
  #####...#      #......#
  #...#.+.#      #.m....#
  #.p.d...#      #......#
  #...#..f#      #f....f#
  #########       ######